10 10
...#......
.#.#.##...
.#....#...
.#..#.#...
.##.####..
.#........
.#.#......
.###.###..
....##....
###.......
