8 10
...#....
.#.#.##.
.#....#.
.#..#.#.
.##.####
.#......
.#.#....
####.###
...#....
.#......
